XXXX-X
--XX-X
X-XX-X
X-XX-X
X----X
XXXXXX